#########
#####  ##
##  #   #
##      #
## ### ##
## #   ##
## #   ##
## ## ###
#  ## B #
#P T#   #
#########