#####################################################
#                           #T                     P#
# B        #                 ##########   ###     # #
#           #                 #       #      #    # #
#            #        #       #       #       #   # #
#             #        #      #       #        #  # #
#              #              #       ##        # # #
#               #             #                   # #
#                #            ######              # #
#                 #                   ############# #
#                  #                                #
#                  ##                               #
#                                                   #
#                                                   #
#####################################################