######
#   P#
# BB #
#    #
#T T #
######