##############
##  ##  #    #
##      #  B #
## ###     ###
## ### ## ####
## #   ## ####
## #   ## ####
## ## ### ####
#  ## B # ####
#  T#     ####
#P T##########
##############