#############
####   ######
####       ##
#####   B  ##
#   # ####  #
# B  B P#T  #
###    ##T  #
##   ########
##   T#######
#############