#############
#####       #
#####   B   #
#   # # ##  #
# BT B P#T  #
#### T###   #
#############