#############
# TTT########
# T##########
##        ###
##   #B   ###
##  BB      #
##   #B  ##P#
####    #####
#############