#########
## TTTT##
##  #####
### #   #
### #BB #
###     #
# BB ## #
#    ##P#
#########