#############
#  TT###TT  #
#  #######  #
##         ##
##   #B    ##
##  BB      #
##   #B  ##P#
####    #####
#############